S.E#.....T
ET##..###.
#.###E###E
#.E...#E#.
###T#####G
