H.E#.....T
ET##..###.
#.###E###E
#.E...###.
###T#####G
